"filename", "language", "JavaScript", "PostCSS", "JavaScript JSX", "XML", "JSON", "comment", "blank", "total"
"c:\Users\dryde\OneDrive\Desktop\Visual Studio Projects\React-QMS-App\package-lock.json", "JSON", 0, 0, 0, 0, 72, 0, 0, 72
"c:\Users\dryde\OneDrive\Desktop\Visual Studio Projects\React-QMS-App\package.json", "JSON", 0, 0, 0, 0, 3, 0, 0, 3
"c:\Users\dryde\OneDrive\Desktop\Visual Studio Projects\React-QMS-App\public\icons\pdf-icon.svg", "XML", 0, 0, 0, 9, 0, 0, 0, 9
"c:\Users\dryde\OneDrive\Desktop\Visual Studio Projects\React-QMS-App\src\api\supabaseApi.js", "JavaScript", 115, 0, 0, 0, 0, 31, 22, 168
"c:\Users\dryde\OneDrive\Desktop\Visual Studio Projects\React-QMS-App\src\components\BadgeGroup.jsx", "JavaScript JSX", 0, 0, 82, 0, 0, 0, 5, 87
"c:\Users\dryde\OneDrive\Desktop\Visual Studio Projects\React-QMS-App\src\components\CTAButton.jsx", "JavaScript JSX", 0, 0, 2, 0, 0, 0, 0, 2
"c:\Users\dryde\OneDrive\Desktop\Visual Studio Projects\React-QMS-App\src\components\FilterPane.jsx", "JavaScript JSX", 0, 0, -3, 0, 0, 0, 0, -3
"c:\Users\dryde\OneDrive\Desktop\Visual Studio Projects\React-QMS-App\src\components\Header.jsx", "JavaScript JSX", 0, 0, -2, 0, 0, 0, 0, -2
"c:\Users\dryde\OneDrive\Desktop\Visual Studio Projects\React-QMS-App\src\components\NCEntryForm.jsx", "JavaScript JSX", 0, 0, 158, 0, 0, 1, 2, 161
"c:\Users\dryde\OneDrive\Desktop\Visual Studio Projects\React-QMS-App\src\components\Navbar.jsx", "JavaScript JSX", 0, 0, 1, 0, 0, 0, 0, 1
"c:\Users\dryde\OneDrive\Desktop\Visual Studio Projects\React-QMS-App\src\components\NonConformance.jsx", "JavaScript JSX", 0, 0, 5, 0, 0, 0, 1, 6
"c:\Users\dryde\OneDrive\Desktop\Visual Studio Projects\React-QMS-App\src\components\NonConformanceCard.jsx", "JavaScript JSX", 0, 0, 7, 0, 0, 0, 0, 7
"c:\Users\dryde\OneDrive\Desktop\Visual Studio Projects\React-QMS-App\src\components\NonConformanceGrid.jsx", "JavaScript JSX", 0, 0, -14, 0, 0, 0, 0, -14
"c:\Users\dryde\OneDrive\Desktop\Visual Studio Projects\React-QMS-App\src\components\NonConformanceRow.jsx", "JavaScript JSX", 0, 0, 2, 0, 0, 0, 0, 2
"c:\Users\dryde\OneDrive\Desktop\Visual Studio Projects\React-QMS-App\src\components\ShieldBadge.jsx", "JavaScript JSX", 0, 0, 76, 0, 0, 1, 5, 82
"c:\Users\dryde\OneDrive\Desktop\Visual Studio Projects\React-QMS-App\src\components\SideMenuItem.jsx", "JavaScript JSX", 0, 0, 9, 0, 0, 0, 0, 9
"c:\Users\dryde\OneDrive\Desktop\Visual Studio Projects\React-QMS-App\src\components\SortPane.jsx", "JavaScript JSX", 0, 0, -3, 0, 0, 0, 1, -2
"c:\Users\dryde\OneDrive\Desktop\Visual Studio Projects\React-QMS-App\src\components\SubMenuItem.jsx", "JavaScript JSX", 0, 0, 7, 0, 0, 0, 0, 7
"c:\Users\dryde\OneDrive\Desktop\Visual Studio Projects\React-QMS-App\src\components\ToastNotification.jsx", "JavaScript JSX", 0, 0, 18, 0, 0, 3, 3, 24
"c:\Users\dryde\OneDrive\Desktop\Visual Studio Projects\React-QMS-App\src\components\ui\DatePickerPopout.jsx", "JavaScript JSX", 0, 0, -1, 0, 0, 0, 0, -1
"c:\Users\dryde\OneDrive\Desktop\Visual Studio Projects\React-QMS-App\src\components\ui\DownloadLink.jsx", "JavaScript JSX", 0, 0, 43, 0, 0, 4, 9, 56
"c:\Users\dryde\OneDrive\Desktop\Visual Studio Projects\React-QMS-App\src\components\ui\FileDrop.jsx", "JavaScript JSX", 0, 0, 327, 0, 0, 7, 26, 360
"c:\Users\dryde\OneDrive\Desktop\Visual Studio Projects\React-QMS-App\src\components\ui\RHFComboBox.jsx", "JavaScript JSX", 0, 0, 202, 0, 0, 0, 19, 221
"c:\Users\dryde\OneDrive\Desktop\Visual Studio Projects\React-QMS-App\src\components\ui\RHFDatePicker.jsx", "JavaScript JSX", 0, 0, 179, 0, 0, 2, 19, 200
"c:\Users\dryde\OneDrive\Desktop\Visual Studio Projects\React-QMS-App\src\components\ui\RHFDatePickerPopout.jsx", "JavaScript JSX", 0, 0, 77, 0, 0, 3, 7, 87
"c:\Users\dryde\OneDrive\Desktop\Visual Studio Projects\React-QMS-App\src\components\ui\RHFStatusComboBox.jsx", "JavaScript JSX", 0, 0, 205, 0, 0, 0, 19, 224
"c:\Users\dryde\OneDrive\Desktop\Visual Studio Projects\React-QMS-App\src\components\ui\RHFTextArea.jsx", "JavaScript JSX", 0, 0, 58, 0, 0, 0, 5, 63
"c:\Users\dryde\OneDrive\Desktop\Visual Studio Projects\React-QMS-App\src\components\ui\RHFUserComboBox.jsx", "JavaScript JSX", 0, 0, 223, 0, 0, 5, 21, 249
"c:\Users\dryde\OneDrive\Desktop\Visual Studio Projects\React-QMS-App\src\components\ui\TextArea.jsx", "JavaScript JSX", 0, 0, 9, 0, 0, 0, 0, 9
"c:\Users\dryde\OneDrive\Desktop\Visual Studio Projects\React-QMS-App\src\components\ui\TextInput.jsx", "JavaScript JSX", 0, 0, 38, 0, 0, 0, 0, 38
"c:\Users\dryde\OneDrive\Desktop\Visual Studio Projects\React-QMS-App\src\components\ui\UserAvatarGroup.jsx", "JavaScript JSX", 0, 0, -1, 0, 0, 0, 1, 0
"c:\Users\dryde\OneDrive\Desktop\Visual Studio Projects\React-QMS-App\src\contexts\ToastProvider.jsx", "JavaScript JSX", 0, 0, 11, 0, 0, -1, 1, 11
"c:\Users\dryde\OneDrive\Desktop\Visual Studio Projects\React-QMS-App\src\contexts\UserProvider.jsx", "JavaScript JSX", 0, 0, -1, 0, 0, 0, 0, -1
"c:\Users\dryde\OneDrive\Desktop\Visual Studio Projects\React-QMS-App\src\index.css", "PostCSS", 0, 75, 0, 0, 0, 2, 10, 87
"c:\Users\dryde\OneDrive\Desktop\Visual Studio Projects\React-QMS-App\src\lib\utils.js", "JavaScript", 65, 0, 0, 0, 0, 0, 12, 77
"c:\Users\dryde\OneDrive\Desktop\Visual Studio Projects\React-QMS-App\src\validationSchema.js", "JavaScript", 96, 0, 0, 0, 0, 0, 4, 100
"Total", "-", 276, 75, 1714, 9, 75, 58, 192, 2399