"filename", "language", "JSON", "JSON with Comments", "PostCSS", "JavaScript JSX", "JavaScript", "comment", "blank", "total"
"c:\Users\dryde\OneDrive\Desktop\Visual Studio Projects\React-QMS-App\components.json", "JSON", 21, 0, 0, 0, 0, 0, 0, 21
"c:\Users\dryde\OneDrive\Desktop\Visual Studio Projects\React-QMS-App\jsconfig.json", "JSON with Comments", 0, 12, 0, 0, 0, 0, 1, 13
"c:\Users\dryde\OneDrive\Desktop\Visual Studio Projects\React-QMS-App\package-lock.json", "JSON", 443, 0, 0, 0, 0, 0, 0, 443
"c:\Users\dryde\OneDrive\Desktop\Visual Studio Projects\React-QMS-App\package.json", "JSON", 7, 0, 0, 0, 0, 0, 0, 7
"c:\Users\dryde\OneDrive\Desktop\Visual Studio Projects\React-QMS-App\src\App.jsx", "JavaScript JSX", 0, 0, 0, -1, 0, 0, -1, -2
"c:\Users\dryde\OneDrive\Desktop\Visual Studio Projects\React-QMS-App\src\SettingMenuStructure.js", "JavaScript", 0, 0, 0, 0, -39, 0, 1, -38
"c:\Users\dryde\OneDrive\Desktop\Visual Studio Projects\React-QMS-App\src\authService.js", "JavaScript", 0, 0, 0, 0, 51, 0, 8, 59
"c:\Users\dryde\OneDrive\Desktop\Visual Studio Projects\React-QMS-App\src\components\ActionsModal.jsx", "JavaScript JSX", 0, 0, 0, -5, 0, 0, 0, -5
"c:\Users\dryde\OneDrive\Desktop\Visual Studio Projects\React-QMS-App\src\components\AuthPage.jsx", "JavaScript JSX", 0, 0, 0, 19, 0, 0, 3, 22
"c:\Users\dryde\OneDrive\Desktop\Visual Studio Projects\React-QMS-App\src\components\CTAButton.jsx", "JavaScript JSX", 0, 0, 0, 17, 0, 0, 2, 19
"c:\Users\dryde\OneDrive\Desktop\Visual Studio Projects\React-QMS-App\src\components\Dashboard.jsx", "JavaScript JSX", 0, 0, 0, 52, 0, 0, 0, 52
"c:\Users\dryde\OneDrive\Desktop\Visual Studio Projects\React-QMS-App\src\components\DashboardCard.jsx", "JavaScript JSX", 0, 0, 0, 55, 0, 0, 3, 58
"c:\Users\dryde\OneDrive\Desktop\Visual Studio Projects\React-QMS-App\src\components\DashboardTable.jsx", "JavaScript JSX", 0, 0, 0, 46, 0, 0, 3, 49
"c:\Users\dryde\OneDrive\Desktop\Visual Studio Projects\React-QMS-App\src\components\DataNavBar.jsx", "JavaScript JSX", 0, 0, 0, 55, 0, 0, 3, 58
"c:\Users\dryde\OneDrive\Desktop\Visual Studio Projects\React-QMS-App\src\components\EmployeeCard.jsx", "JavaScript JSX", 0, 0, 0, 32, 0, 0, 3, 35
"c:\Users\dryde\OneDrive\Desktop\Visual Studio Projects\React-QMS-App\src\components\Employees.jsx", "JavaScript JSX", 0, 0, 0, 68, 0, 0, 7, 75
"c:\Users\dryde\OneDrive\Desktop\Visual Studio Projects\React-QMS-App\src\components\FilterPane.jsx", "JavaScript JSX", 0, 0, 0, 6, 0, 0, 3, 9
"c:\Users\dryde\OneDrive\Desktop\Visual Studio Projects\React-QMS-App\src\components\Header.jsx", "JavaScript JSX", 0, 0, 0, 5, 0, 0, 1, 6
"c:\Users\dryde\OneDrive\Desktop\Visual Studio Projects\React-QMS-App\src\components\HomeRedirect.jsx", "JavaScript JSX", 0, 0, 0, 11, 0, 1, 4, 16
"c:\Users\dryde\OneDrive\Desktop\Visual Studio Projects\React-QMS-App\src\components\Login.jsx", "JavaScript JSX", 0, 0, 0, 129, 0, 1, 6, 136
"c:\Users\dryde\OneDrive\Desktop\Visual Studio Projects\React-QMS-App\src\components\Logout.jsx", "JavaScript JSX", 0, 0, 0, 12, 0, 1, 1, 14
"c:\Users\dryde\OneDrive\Desktop\Visual Studio Projects\React-QMS-App\src\components\NCEntryForm.jsx", "JavaScript JSX", 0, 0, 0, 223, 0, -17, 6, 212
"c:\Users\dryde\OneDrive\Desktop\Visual Studio Projects\React-QMS-App\src\components\NavItem.jsx", "JavaScript JSX", 0, 0, 0, 2, 0, 0, 0, 2
"c:\Users\dryde\OneDrive\Desktop\Visual Studio Projects\React-QMS-App\src\components\Navbar.jsx", "JavaScript JSX", 0, 0, 0, 8, 0, 0, 1, 9
"c:\Users\dryde\OneDrive\Desktop\Visual Studio Projects\React-QMS-App\src\components\NonConformance.jsx", "JavaScript JSX", 0, 0, 0, 43, 0, 0, 5, 48
"c:\Users\dryde\OneDrive\Desktop\Visual Studio Projects\React-QMS-App\src\components\NonConformanceCard.jsx", "JavaScript JSX", 0, 0, 0, 24, 0, 3, 6, 33
"c:\Users\dryde\OneDrive\Desktop\Visual Studio Projects\React-QMS-App\src\components\NonConformanceGrid.jsx", "JavaScript JSX", 0, 0, 0, 0, 0, -1, 0, -1
"c:\Users\dryde\OneDrive\Desktop\Visual Studio Projects\React-QMS-App\src\components\NonConformanceRow.jsx", "JavaScript JSX", 0, 0, 0, 10, 0, 3, 6, 19
"c:\Users\dryde\OneDrive\Desktop\Visual Studio Projects\React-QMS-App\src\components\NonConformanceTable.jsx", "JavaScript JSX", 0, 0, 0, 15, 0, 0, 1, 16
"c:\Users\dryde\OneDrive\Desktop\Visual Studio Projects\React-QMS-App\src\components\ProtectedRoute.jsx", "JavaScript JSX", 0, 0, 0, 8, 0, 0, 5, 13
"c:\Users\dryde\OneDrive\Desktop\Visual Studio Projects\React-QMS-App\src\components\Settings.jsx", "JavaScript JSX", 0, 0, 0, 21, 0, 0, 2, 23
"c:\Users\dryde\OneDrive\Desktop\Visual Studio Projects\React-QMS-App\src\components\SettingsAccount.jsx", "JavaScript JSX", 0, 0, 0, 53, 0, 4, 5, 62
"c:\Users\dryde\OneDrive\Desktop\Visual Studio Projects\React-QMS-App\src\components\SideMenuItem.jsx", "JavaScript JSX", 0, 0, 0, 36, 0, 0, 3, 39
"c:\Users\dryde\OneDrive\Desktop\Visual Studio Projects\React-QMS-App\src\components\SignUp.jsx", "JavaScript JSX", 0, 0, 0, 169, 0, 0, 7, 176
"c:\Users\dryde\OneDrive\Desktop\Visual Studio Projects\React-QMS-App\src\components\Skeleton.jsx", "JavaScript JSX", 0, 0, 0, 13, 0, 0, 3, 16
"c:\Users\dryde\OneDrive\Desktop\Visual Studio Projects\React-QMS-App\src\components\ViewToggle.jsx", "JavaScript JSX", 0, 0, 0, 1, 0, 0, 0, 1
"c:\Users\dryde\OneDrive\Desktop\Visual Studio Projects\React-QMS-App\src\components\charts\BarChart.jsx", "JavaScript JSX", 0, 0, 0, 66, 0, 0, 5, 71
"c:\Users\dryde\OneDrive\Desktop\Visual Studio Projects\React-QMS-App\src\components\ui\ComboBox.jsx", "JavaScript JSX", 0, 0, 0, -6, 0, 0, -2, -8
"c:\Users\dryde\OneDrive\Desktop\Visual Studio Projects\React-QMS-App\src\components\ui\FloatingTextInput.jsx", "JavaScript JSX", 0, 0, 0, 29, 0, 0, 4, 33
"c:\Users\dryde\OneDrive\Desktop\Visual Studio Projects\React-QMS-App\src\components\ui\StatusComboBox.jsx", "JavaScript JSX", 0, 0, 0, 189, 0, 0, 19, 208
"c:\Users\dryde\OneDrive\Desktop\Visual Studio Projects\React-QMS-App\src\components\ui\UserAvatarGroup.jsx", "JavaScript JSX", 0, 0, 0, 40, 0, 0, 4, 44
"c:\Users\dryde\OneDrive\Desktop\Visual Studio Projects\React-QMS-App\src\components\ui\UserComboBox.jsx", "JavaScript JSX", 0, 0, 0, 13, 0, 0, -1, 12
"c:\Users\dryde\OneDrive\Desktop\Visual Studio Projects\React-QMS-App\src\components\ui\card.jsx", "JavaScript JSX", 0, 0, 0, 83, 0, 0, 10, 93
"c:\Users\dryde\OneDrive\Desktop\Visual Studio Projects\React-QMS-App\src\components\ui\chart.jsx", "JavaScript JSX", 0, 0, 0, 262, 0, 2, 34, 298
"c:\Users\dryde\OneDrive\Desktop\Visual Studio Projects\React-QMS-App\src\contexts\AuthProvider.jsx", "JavaScript JSX", 0, 0, 0, 27, 0, 0, 8, 35
"c:\Users\dryde\OneDrive\Desktop\Visual Studio Projects\React-QMS-App\src\contexts\ConfirmationModalProvider.jsx", "JavaScript JSX", 0, 0, 0, 3, 0, 0, 0, 3
"c:\Users\dryde\OneDrive\Desktop\Visual Studio Projects\React-QMS-App\src\contexts\UserProvider.jsx", "JavaScript JSX", 0, 0, 0, 36, 0, 0, 9, 45
"c:\Users\dryde\OneDrive\Desktop\Visual Studio Projects\React-QMS-App\src\hooks\useNCM.jsx", "JavaScript JSX", 0, 0, 0, 8, 0, 0, 3, 11
"c:\Users\dryde\OneDrive\Desktop\Visual Studio Projects\React-QMS-App\src\hooks\useNCMFilters.jsx", "JavaScript JSX", 0, 0, 0, -2, 0, 2, -1, -1
"c:\Users\dryde\OneDrive\Desktop\Visual Studio Projects\React-QMS-App\src\hooks\useSignedAvatarURL.jsx", "JavaScript JSX", 0, 0, 0, 34, 0, 0, 10, 44
"c:\Users\dryde\OneDrive\Desktop\Visual Studio Projects\React-QMS-App\src\index.css", "PostCSS", 0, 0, 91, 0, 0, 0, 1, 92
"c:\Users\dryde\OneDrive\Desktop\Visual Studio Projects\React-QMS-App\src\lib\csvHelper.jsx", "JavaScript JSX", 0, 0, 0, 31, 0, 4, 10, 45
"c:\Users\dryde\OneDrive\Desktop\Visual Studio Projects\React-QMS-App\src\lib\utils.js", "JavaScript", 0, 0, 0, 0, 5, 0, 2, 7
"c:\Users\dryde\OneDrive\Desktop\Visual Studio Projects\React-QMS-App\src\main.jsx", "JavaScript JSX", 0, 0, 0, 48, 0, 0, 0, 48
"c:\Users\dryde\OneDrive\Desktop\Visual Studio Projects\React-QMS-App\vite.config.js", "JavaScript", 0, 0, 0, 0, 11, 0, 0, 11
"Total", "-", 471, 12, 91, 1988, 28, 3, 213, 2806